111111111444111111111
122222222444222222221
123333333444333333321
123000044444444444321
123000044444444444321
123000000000000044321
123000000000000044321
123000000000000044321
123000000000000044321
123000000000000044321
123000000000000044321
123000000000000044321
123000000000000044321
123444444544444444321
123444544444445444321
123440000000000000321
123444444444444444321
123444444444444444321
123333333333333333321
122222222222222222221
111111111111111111111