111111111444111111111
122222222444222222221
123333333444333333321
123000044444440000321
123000044444440000321
123000000444000000321
123000000444000000321
123000000444000000321
123000000555000000321
123000000555000000321
123000000555000000321
123000000666000000321
123000000666000000321
123000000666000000321
123000000555000000321
123555555555555555321
123550000000000055321
123550000000000055321
123550000000000055321
122550550555055055221
111111111111111111111