111111111444111111111
122222222444222222221
123333333444333333321
123000000444444444321
123000000444444444321
123000000000000044321
123000000000000044321
123000000000000055321
123000000000000055321
123000000000000066321
123000000000000066321
123000000000000077321
123777700000007777321
123777700000007777321
123777700000007777321
123660000000000000321
123660000000000000321
123550000550000999321
123550000550000999321
122550000550000999221	
111111111111111111111