000000000222000000000000000000
000000000222000000000000000000
000000000222000000000000000000
000000000222222220220000203040
000000000222222220220220000000
000000000000000000000000000040
000000000000000000000000600000
000000000555555555500770005050
999000000555555555500770000000
999000055555555555567770000000
999000000555555555500000000000
999000000555555555500000000000
880000000000000000000000000000
880000000880000000000000000000
770000000770000000000000000000
770000000770000000000000000000
770000000880000000000000000000
880000000880000000000000000000
770000000990000000000000000000
770000000770000000000000000000
770000000770000000000000000000
880000000880000000000000000000
880000000880000000000000000000
880000000003333333300000000000
888776655443333333300000000000
888776655443333333300000000000
000000000003333333333333333333
000000000003333333300000000044